46 46 46 46 46 46 46 46 46 46 46 46 46 46 46 46 46 46 46 46 46 46 46 46 46 46 46 46 46 46 46 46 46 46 46 46 46 46 46 46 46 46 46 46 46 46 39 42 42 39 
46 46 46 46 46 46 46 46 46 46 46 46 46 46 46 46 46 46 46 46 46 46 46 46 46 46 46 46 46 46 46 46 46 46 46 46 46 46 46 46 46 46 46 46 46 46 39 42 42 39 
46 46 46 46 46 46 46 46 46 46 46 46 46 46 46 46 46 46 46 46 46 46 46 46 46 46 46 46 46 46 46 46 46 46 46 46 46 46 46 46 46 46 46 46 46 46 39 42 42 39 
46 46 46 46 46 46 46 46 46 46 46 46 46 46 46 46 46 46 46 46 46 46 46 46 46 46 46 46 46 46 46 46 46 46 46 46 46 46 46 46 46 46 46 46 46 46 39 42 42 39 
46 46 46 46 46 46 46 46 46 46 46 46 46 46 46 46 46 46 46 46 46 46 46 46 46 46 46 46 46 46 46 46 46 46 46 46 46 46 46 46 46 46 46 46 46 46 39 42 42 39 
46 46 46 46 46 46 46 46 46 46 46 46 46 46 46 46 46 46 46 46 46 46 46 46 46 46 46 46 46 46 46 46 46 46 46 46 46 46 46 46 46 46 46 46 46 46 39 42 42 39 
46 46 46 46 46 46 46 46 46 46 46 46 46 46 46 46 46 46 46 46 46 46 46 46 46 46 46 46 46 46 46 46 46 46 46 46 46 46 46 46 46 46 46 46 46 46 39 42 42 39 
46 46 46 46 46 46 46 46 46 46 46 46 46 46 46 46 46 46 46 46 46 46 46 46 46 46 46 46 46 46 46 46 46 46 46 46 46 46 46 46 46 46 46 46 46 46 39 42 42 39 
46 46 46 46 46 46 46 46 46 46 46 46 46 46 46 46 46 46 46 46 46 46 46 46 46 46 46 46 46 46 46 46 46 46 46 46 46 46 46 46 46 46 46 46 46 46 39 42 42 39 
46 46 46 46 46 46 46 46 46 46 46 46 46 46 46 46 46 46 46 46 46 46 46 46 46 46 46 46 46 46 46 46 46 46 46 46 46 46 46 46 46 46 46 46 46 46 39 42 42 39 
46 46 46 46 46 46 46 46 46 46 46 46 46 46 46 46 46 46 46 46 46 46 46 46 46 46 46 46 46 46 46 46 46 46 46 46 46 46 46 46 46 46 46 46 46 46 39 42 42 39 
46 46 46 46 46 46 46 46 46 46 46 46 46 46 46 46 46 46 46 46 46 46 46 46 46 46 46 46 46 46 46 46 46 46 46 46 46 46 46 46 46 46 46 46 46 46 39 42 42 39 
46 46 46 46 46 46 46 46 46 46 46 46 46 46 46 46 46 46 46 46 46 46 46 46 46 46 46 46 46 46 46 46 46 46 46 46 46 46 46 46 46 46 46 46 46 46 39 42 42 39 
46 46 46 46 46 46 46 46 39 39 39 39 39 39 39 39 39 39 39 39 39 39 39 39 39 39 39 39 39 39 39 39 39 39 39 39 39 39 39 39 39 39 39 46 46 46 39 42 42 39 
46 46 46 46 46 46 46 46 39 39 44 44 44 44 44 44 44 44 44 44 44 39 26 26 26 26 26 26 30 17 12 12 12 12 12 18 31 26 26 26 26 26 39 46 46 46 39 42 42 39 
46 46 46 46 46 46 46 46 39 39 44 44 44 44 44 44 44 44 44 44 44 39 26 26 26 26 26 26 30 19 20 20 20 20 20 21 31 26 26 26 26 26 39 46 46 46 39 42 42 39 
46 46 46 46 46 46 46 46 39 39 44 44 44 44 44 44 44 44 39 39 39 39 26 26 26 26 26 27 38 11 11 11 11 11 11 11 31 26 26 26 26 26 39 46 46 46 39 42 42 39 
46 46 46 46 46 46 46 46 39 39 44 44 44 44 44 44 44 39 39 26 26 26 26 26 26 26 26 30 11 11 11 11 11 11 11 11 31 26 26 26 26 26 39 46 46 46 39 42 42 39 
46 46 46 46 46 46 46 46 39 39 44 44 44 44 44 44 39 39 26 26 26 26 26 26 26 26 26 30 14 15 15 15 15 15 16 35 34 26 26 26 26 26 39 46 46 46 39 42 42 39 
46 46 46 46 46 46 46 46 39 39 44 44 44 44 39 39 39 26 26 26 27 28 28 28 28 28 28 38 17 12 12 12 12 12 18 31 26 26 26 26 26 26 39 46 46 46 39 42 42 39 
39 39 39 39 39 39 39 39 39 39 39 39 39 39 39 26 26 26 26 26 30 14 15 15 15 15 15 15 25 12 12 12 12 12 18 31 26 26 26 26 26 26 39 46 46 46 39 42 42 39 
42 42 42 42 42 42 42 42 42 42 45 26 26 26 26 26 26 26 26 26 30 17 12 12 12 12 12 12 12 12 12 12 12 12 18 37 28 28 28 28 28 28 39 46 46 46 39 42 42 39 
42 42 42 42 42 42 42 42 42 42 45 26 26 26 26 26 26 26 26 26 30 17 12 12 12 12 12 12 12 12 12 12 12 12 24 15 15 15 15 15 15 15 39 46 46 46 39 42 42 39 
39 39 39 39 39 39 39 39 39 39 39 39 39 39 39 39 39 26 26 26 30 19 23 12 12 12 12 12 12 12 12 12 12 12 12 12 12 12 12 12 12 12 39 46 46 46 39 42 42 39 
46 46 46 46 46 46 46 46 39 39 44 44 44 44 44 44 39 39 26 26 32 11 19 20 20 20 20 20 20 20 20 20 20 20 23 12 12 12 12 12 12 12 39 46 46 46 39 42 42 39 
46 46 46 46 46 46 46 46 39 39 44 44 44 44 44 44 44 39 39 26 26 32 33 33 33 33 33 33 33 33 33 33 33 36 17 12 12 12 12 12 12 12 39 46 46 46 39 42 42 39 
46 46 46 46 46 46 46 46 39 39 44 44 44 44 44 44 44 44 39 39 39 26 26 26 26 26 26 26 26 26 26 26 26 30 19 20 20 20 20 20 20 20 39 39 39 39 39 42 42 39 
46 46 46 46 46 46 46 46 39 39 44 44 44 44 44 44 44 44 44 44 39 39 26 26 26 26 26 26 26 26 26 26 26 30 11 11 11 11 11 11 11 45 42 42 42 42 42 42 42 39 
46 46 46 46 46 46 46 46 39 39 44 44 44 44 44 44 44 44 44 44 44 39 39 26 26 26 26 26 26 26 26 26 26 30 11 11 11 11 11 11 11 45 42 42 42 42 42 42 42 39 
46 46 46 46 46 46 46 46 39 39 44 44 44 44 44 44 44 44 44 44 44 44 39 39 39 26 26 26 26 26 26 26 26 30 14 15 15 15 15 15 15 15 39 39 39 39 39 39 39 39 
46 46 46 46 46 46 46 46 39 39 44 44 44 44 44 44 44 44 44 44 44 44 44 44 39 26 26 26 26 26 26 26 26 30 17 12 12 12 12 12 12 12 39 46 46 46 46 46 46 46 
46 46 46 46 46 46 46 46 39 39 44 44 44 44 44 44 44 44 44 44 44 44 44 44 39 26 26 26 26 26 26 26 26 30 17 12 12 12 12 12 12 12 39 46 46 46 46 46 46 46 
46 46 46 46 46 46 46 46 39 39 39 39 39 39 39 39 39 39 39 39 39 39 39 39 39 39 39 39 39 39 39 39 39 39 39 39 39 39 39 39 39 39 39 46 46 46 46 46 46 46 
46 46 46 46 46 46 46 46 46 46 46 46 46 46 46 46 46 46 46 46 46 46 46 46 46 46 46 46 46 46 46 46 46 46 46 46 46 46 46 46 46 46 46 46 46 46 46 46 46 46 
46 46 46 46 46 46 46 46 46 46 46 46 46 46 46 46 46 46 46 46 46 46 46 46 46 46 46 46 46 46 46 46 46 46 46 46 46 46 46 46 46 46 46 46 46 46 46 46 46 46 
46 46 46 46 46 46 46 46 46 46 46 46 46 46 46 46 46 46 46 46 46 46 46 46 46 46 46 46 46 46 46 46 46 46 46 46 46 46 46 46 46 46 46 46 46 46 46 46 46 46 
46 46 46 46 46 46 46 46 46 46 46 46 46 46 46 46 46 46 46 46 46 46 46 46 46 46 46 46 46 46 46 46 46 46 46 46 46 46 46 46 46 46 46 46 46 46 46 46 46 46 
46 46 46 46 46 46 46 46 46 46 46 46 46 46 46 46 46 46 46 46 46 46 46 46 46 46 46 46 46 46 46 46 46 46 46 46 46 46 46 46 46 46 46 46 46 46 46 46 46 46 
46 46 46 46 46 46 46 46 46 46 46 46 46 46 46 46 46 46 46 46 46 46 46 46 46 46 46 46 46 46 46 46 46 46 46 46 46 46 46 46 46 46 46 46 46 46 46 46 46 46 
46 46 46 46 46 46 46 46 46 46 46 46 46 46 46 46 46 46 46 46 46 46 46 46 46 46 46 46 46 46 46 46 46 46 46 46 46 46 46 46 46 46 46 46 46 46 46 46 46 46 
46 46 46 46 46 46 46 46 46 46 46 46 46 46 46 46 46 46 46 46 46 46 46 46 46 46 46 46 46 46 46 46 46 46 46 46 46 46 46 46 46 46 46 46 46 46 46 46 46 46 
46 46 46 46 46 46 46 46 46 46 46 46 46 46 46 46 46 46 46 46 46 46 46 46 46 46 46 46 46 46 46 46 46 46 46 46 46 46 46 46 46 46 46 46 46 46 46 46 46 46 
46 46 46 46 46 46 46 46 46 46 46 46 46 46 46 46 46 46 46 46 46 46 46 46 46 46 46 46 46 46 46 46 46 46 46 46 46 46 46 46 46 46 46 46 46 46 46 46 46 46 
46 46 46 46 46 46 46 46 46 46 46 46 46 46 46 46 46 46 46 46 46 46 46 46 46 46 46 46 46 46 46 46 46 46 46 46 46 46 46 46 46 46 46 46 46 46 46 46 46 46 
46 46 46 46 46 46 46 46 46 46 46 46 46 46 46 46 46 46 46 46 46 46 46 46 46 46 46 46 46 46 46 46 46 46 46 46 46 46 46 46 46 46 46 46 46 46 46 46 46 46 
46 46 46 46 46 46 46 46 46 46 46 46 46 46 46 46 46 46 46 46 46 46 46 46 46 46 46 46 46 46 46 46 46 46 46 46 46 46 46 46 46 46 46 46 46 46 46 46 46 46 
46 46 46 46 46 46 46 46 46 46 46 46 46 46 46 46 46 46 46 46 46 46 46 46 46 46 46 46 46 46 46 46 46 46 46 46 46 46 46 46 46 46 46 46 46 46 46 46 46 46 
46 46 46 46 46 46 46 46 46 46 46 46 46 46 46 46 46 46 46 46 46 46 46 46 46 46 46 46 46 46 46 46 46 46 46 46 46 46 46 46 46 46 46 46 46 46 46 46 46 46 
46 46 46 46 46 46 46 46 46 46 46 46 46 46 46 46 46 46 46 46 46 46 46 46 46 46 46 46 46 46 46 46 46 46 46 46 46 46 46 46 46 46 46 46 46 46 46 46 46 46 
46 46 46 46 46 46 46 46 46 46 46 46 46 46 46 46 46 46 46 46 46 46 46 46 46 46 46 46 46 46 46 46 46 46 46 46 46 46 46 46 46 46 46 46 46 46 46 46 46 46 
