46 46 46 46 46 46 46 46 46 46 46 46 46 46 46 46 46 46 46 46 46 46 46 46 46 46 46 46 46 46 46 46 46 46 46 46 46 46 46 46 46 46 46 46 46 46 46 46 46 46 
46 46 46 46 46 46 46 46 46 46 46 46 46 46 46 46 46 46 46 46 46 46 46 46 46 46 46 46 46 46 46 46 46 46 46 46 46 46 46 46 46 46 46 46 46 46 46 46 46 46 
46 46 46 46 46 46 46 46 46 46 46 46 46 46 46 46 46 46 46 46 46 46 46 46 46 46 46 46 46 46 46 46 46 46 46 46 46 46 46 46 46 46 46 46 46 46 46 46 46 46 
46 46 46 46 46 46 46 46 46 46 46 46 46 46 46 46 46 46 46 46 46 46 46 46 46 46 46 46 46 46 46 46 46 46 46 46 46 46 46 46 46 46 46 46 46 46 46 46 46 46 
46 46 46 46 46 46 46 46 46 46 46 46 46 46 46 46 46 46 46 46 46 46 46 46 46 46 46 46 46 46 46 46 46 46 46 46 46 46 46 46 46 46 46 46 46 46 46 46 46 46 
46 46 46 46 46 46 46 46 46 46 46 46 46 46 46 46 46 46 46 46 46 46 46 46 46 46 46 46 46 46 46 46 46 46 46 46 46 46 46 46 46 46 46 46 46 46 46 46 46 46 
46 46 46 46 46 46 46 46 46 46 46 46 46 46 46 46 46 46 46 46 46 46 46 46 46 46 46 46 46 46 46 46 46 46 46 46 46 46 46 46 46 46 46 46 46 46 46 46 46 46 
46 46 46 46 46 46 46 46 46 46 46 46 46 46 46 46 46 46 46 46 46 46 46 46 46 46 46 46 46 46 46 46 46 46 46 46 46 46 46 46 46 46 46 46 46 46 46 46 46 46 
46 46 46 46 46 46 46 46 46 46 46 46 46 46 46 46 46 46 46 46 46 46 46 46 46 46 46 46 46 46 46 46 46 46 46 46 46 46 46 46 46 46 46 46 46 46 46 46 46 46 
46 46 46 46 46 46 46 46 46 46 46 46 46 46 46 46 46 46 46 46 46 46 46 46 46 46 46 46 46 46 46 46 46 46 46 46 46 46 46 46 46 46 46 46 46 46 46 46 46 46 
46 46 46 46 46 46 46 46 46 46 46 46 46 46 46 46 46 46 46 46 46 46 46 46 46 46 46 46 46 46 46 46 46 46 46 46 46 46 46 46 46 46 46 46 46 46 46 46 46 46 
46 46 46 46 46 46 46 46 46 46 46 46 46 46 46 46 46 46 46 46 46 46 46 46 46 46 46 46 46 46 46 46 46 46 46 46 46 46 46 46 46 46 46 46 46 46 46 46 46 46 
46 46 46 46 46 46 46 46 46 46 46 46 46 46 46 46 46 46 46 46 46 46 46 46 46 46 46 46 46 46 46 46 46 46 46 46 46 46 46 46 46 46 46 46 46 46 46 46 46 46 
46 46 46 46 46 46 46 46 46 46 46 46 46 46 46 46 46 46 46 46 46 46 46 46 46 46 46 46 46 46 46 46 46 46 46 46 46 46 46 46 46 46 46 46 46 46 46 46 46 46 
46 46 46 46 46 46 46 46 46 46 46 46 46 46 46 46 46 46 46 46 46 46 46 46 46 46 46 46 46 46 46 46 46 46 46 46 46 46 46 46 46 46 46 46 46 46 46 46 46 46 
46 46 46 46 46 46 46 46 46 46 46 46 46 46 46 46 46 46 46 46 46 46 46 46 46 46 46 46 46 46 46 46 46 46 46 46 46 46 46 46 46 46 46 46 46 46 46 46 46 46 
46 46 46 46 46 46 46 46 46 46 46 46 46 46 46 46 46 46 46 46 46 46 46 46 46 46 46 46 46 46 46 46 46 46 46 46 46 46 46 46 46 46 46 46 46 46 46 46 46 46 
46 46 46 46 46 46 46 46 46 46 46 46 46 46 46 46 46 46 46 46 46 46 46 46 46 46 46 46 46 46 46 46 46 46 46 46 46 46 46 46 46 46 46 46 46 46 46 46 46 46 
46 46 46 46 46 46 46 46 46 46 46 46 46 46 46 46 46 46 46 46 46 46 46 46 46 46 46 46 46 46 46 46 46 46 46 46 46 46 46 46 46 46 46 46 46 46 46 46 46 46 
46 46 46 46 46 46 46 46 46 46 46 46 46 46 46 46 46 46 46 46 46 46 46 46 46 46 46 46 46 46 46 46 46 46 46 46 46 46 46 46 46 46 46 46 46 46 46 46 46 46 
46 46 46 46 46 46 46 46 46 46 46 46 46 46 46 46 46 46 46 46 46 46 46 46 46 46 46 46 46 46 46 46 46 46 46 46 46 46 46 46 46 46 46 46 46 46 46 46 46 46 
46 46 46 46 46 46 46 46 46 46 46 46 46 46 46 46 46 46 46 46 46 46 46 46 46 46 46 46 46 46 46 46 46 46 46 46 46 46 46 46 46 46 46 46 46 46 46 46 46 46 
46 46 46 46 46 46 46 46 46 46 46 46 46 46 46 46 46 46 46 46 46 46 46 46 46 46 46 46 46 46 46 46 46 46 46 46 46 46 46 46 46 46 46 46 46 46 46 46 46 46 
46 46 46 46 46 46 46 46 46 46 46 46 46 46 46 46 46 46 46 46 46 46 46 46 46 46 46 46 46 46 46 46 46 46 46 46 46 46 46 46 46 46 46 46 46 46 46 46 46 46 
46 46 46 46 46 46 46 46 46 46 46 46 46 46 46 46 46 46 46 46 46 46 46 46 46 46 46 46 46 46 46 46 46 46 46 46 46 46 46 46 46 46 46 46 46 46 46 46 46 46 
46 46 46 46 46 46 46 46 46 46 46 46 46 46 46 46 46 46 46 46 46 46 46 46 46 46 46 46 46 46 46 46 46 46 46 46 46 46 46 46 46 46 46 46 46 46 46 46 46 46 
46 46 46 46 46 46 46 46 46 46 46 46 46 46 46 46 46 46 46 46 46 46 46 46 46 46 46 46 46 46 46 46 46 46 46 46 46 46 46 46 46 46 46 46 46 46 46 46 46 46 
46 46 46 46 46 46 46 46 46 46 46 46 46 46 46 46 46 46 46 46 46 46 46 46 46 46 46 46 46 46 46 46 46 46 46 46 46 46 46 46 46 46 46 46 46 46 46 46 46 46 
46 46 46 46 46 46 46 46 46 46 46 46 46 46 46 46 46 46 46 46 46 46 46 46 46 46 46 46 46 46 46 46 46 46 46 46 46 46 46 46 46 46 46 46 46 46 46 46 46 46 
46 46 46 46 46 46 46 46 46 46 46 46 46 46 46 46 46 46 46 46 46 46 46 46 46 46 46 46 46 46 46 46 46 46 46 46 46 46 46 46 46 46 46 46 46 46 46 46 46 46 
46 46 46 46 46 46 46 46 46 46 46 46 46 46 46 46 46 46 46 46 46 46 46 46 46 46 46 46 46 46 46 46 46 46 46 46 46 46 46 46 46 46 46 46 46 46 46 46 46 46 
46 46 46 46 46 46 46 39 39 39 39 39 39 39 39 39 39 39 39 39 39 39 39 39 39 39 39 39 39 39 39 39 39 39 39 39 39 39 39 39 39 46 46 46 46 46 46 46 46 46 
46 46 46 46 46 46 46 39 44 44 44 44 44 44 44 44 44 44 44 44 44 39 26 26 30 14 16 31 26 26 39 44 44 44 44 44 44 44 44 44 39 46 46 46 46 46 46 46 46 46 
46 46 46 46 46 46 46 39 44 44 44 44 44 44 44 44 44 44 44 44 44 39 26 26 30 19 21 31 26 26 39 44 44 44 44 44 44 44 44 44 39 46 46 46 46 46 46 46 46 46 
46 46 46 46 46 46 46 39 44 44 44 44 44 44 44 44 44 44 44 44 44 39 39 39 32 33 33 34 39 39 39 44 44 44 39 39 39 39 39 39 39 39 39 39 39 39 39 39 39 39 
46 46 46 46 46 46 46 39 44 44 44 44 44 44 44 44 44 44 44 44 44 44 44 39 39 26 26 39 39 44 44 44 44 39 39 26 26 26 26 45 42 42 42 42 42 42 42 42 42 42 
46 46 46 46 46 46 46 39 44 44 44 44 44 44 44 44 44 44 44 44 44 44 44 44 39 26 26 39 44 44 44 44 39 39 26 26 26 26 39 39 39 39 39 39 39 39 39 39 39 39 
46 46 46 46 46 46 46 39 44 44 44 44 44 44 44 44 44 44 44 44 44 44 44 44 39 26 26 39 44 44 44 39 39 26 26 26 26 39 39 44 39 46 46 46 46 46 46 46 46 46 
46 46 46 46 46 46 46 39 44 44 44 44 44 44 44 44 44 44 44 44 44 44 44 44 39 26 26 39 44 44 39 39 26 26 26 26 39 39 44 44 39 46 46 46 46 46 46 46 46 46 
46 46 46 46 46 46 46 39 44 44 44 44 44 44 44 44 44 44 44 44 44 44 44 44 39 26 26 39 44 44 39 26 26 26 26 39 39 44 44 44 39 46 46 46 46 46 46 46 46 46 
46 46 46 46 46 46 46 39 44 44 44 44 44 44 44 39 39 39 39 39 39 39 39 39 39 26 26 39 39 39 39 26 26 26 39 39 44 44 44 44 39 46 46 46 46 46 46 46 46 46 
46 46 46 46 46 46 46 39 44 44 44 44 44 44 44 39 26 26 26 26 26 26 26 26 26 26 26 26 26 26 26 26 26 26 39 44 44 44 44 44 39 46 46 46 46 46 46 46 46 46 
46 46 46 46 46 46 46 39 44 44 44 44 44 44 44 39 26 26 26 26 26 26 26 27 28 28 29 26 26 26 26 26 39 39 39 44 44 44 44 44 39 46 46 46 46 46 46 46 46 46 
46 46 46 46 46 46 46 39 44 44 44 44 44 44 44 39 26 26 26 26 26 26 26 30 40 10 31 26 26 26 26 39 39 44 44 44 44 44 44 44 39 46 46 46 46 46 46 46 46 46 
46 46 46 46 46 46 46 39 44 44 44 44 44 44 44 39 26 26 26 26 26 26 26 30 10 40 31 26 39 39 39 39 44 44 44 44 44 44 44 44 39 46 46 46 46 46 46 46 46 46 
46 46 46 46 46 46 46 39 44 44 44 44 44 44 44 39 26 26 26 39 39 39 26 32 33 33 34 26 39 44 44 44 44 44 44 44 44 44 44 44 39 46 46 46 46 46 46 46 46 46 
46 46 46 46 46 46 46 39 44 44 44 44 44 44 44 39 26 26 26 39 44 39 39 39 26 26 26 39 39 44 44 44 44 44 44 44 44 44 44 44 39 46 46 46 46 46 46 46 46 46 
46 46 46 46 46 46 46 39 44 44 44 44 44 44 44 39 39 39 39 39 44 44 44 39 26 26 26 39 44 44 44 44 44 44 44 44 44 44 44 44 39 46 46 46 46 46 46 46 46 46 
46 46 46 46 46 46 46 39 44 44 44 44 44 44 44 44 44 44 44 44 44 44 44 39 45 45 39 39 44 44 44 44 44 44 44 44 44 44 44 44 39 46 46 46 46 46 46 46 46 46 
46 46 46 46 46 46 46 39 39 39 39 39 39 39 39 39 39 39 39 39 39 39 39 39 39 39 39 39 39 39 39 39 39 39 39 39 39 39 39 39 39 46 46 46 46 46 46 46 46 46 
