12 12 12 12 12 12 12 12 12 12 12 12 12 12 12 12 12 12 12 12 12 12 12 12 12 12 12 12 12 12 12 12 12 12 12 12 12 12 12 12 12 12 12 12 12 12 12 12 12 12 
12 12 12 12 12 12 12 12 12 12 12 12 12 12 13 12 12 12 12 12 12 12 12 12 12 12 12 12 12 12 12 12 12 12 12 12 12 12 12 12 12 12 12 12 12 12 12 12 12 12 
12 12 12 12 12 12 12 13 12 12 12 12 12 12 12 12 12 12 12 12 12 12 12 12 12 13 12 12 12 12 12 12 12 13 12 12 12 12 12 12 12 12 12 12 12 12 12 12 12 12 
12 12 12 12 13 12 12 12 12 12 12 13 12 12 12 12 12 12 13 12 12 12 12 12 12 12 12 13 12 12 12 12 12 12 12 12 12 12 12 12 12 13 12 12 12 12 12 12 12 12 
12 12 12 12 12 12 12 12 12 13 12 12 12 12 12 13 12 12 12 12 12 12 12 13 12 12 12 12 12 12 12 13 12 12 13 12 12 12 13 12 12 12 12 12 12 12 12 12 12 12 
12 12 12 12 12 12 12 12 12 12 12 12 12 12 12 12 12 12 12 12 12 13 12 12 12 12 12 12 12 13 12 12 12 12 12 12 13 12 12 12 12 12 12 13 12 12 12 12 12 12 
12 12 12 12 12 13 22 20 20 20 20 20 20 20 23 12 12 12 22 20 20 20 20 20 20 20 20 23 12 12 12 22 20 20 20 20 20 20 20 20 20 20 23 12 12 12 12 12 12 12 
12 12 12 12 12 12 18 40 39 39 39 39 39 40 19 20 20 20 21 40 10 10 11 10 10 10 10 19 20 20 20 21 40 10 35 33 33 33 33 33 33 36 17 12 12 13 12 12 12 12 
12 12 13 12 12 12 18 40 39 42 42 42 39 40 40 40 40 40 40 40 10 14 15 15 15 16 10 40 40 40 40 40 40 40 31 26 26 27 28 29 26 30 17 12 12 12 12 12 12 12 
12 12 12 12 12 12 18 40 39 42 43 42 39 40 40 40 40 40 40 40 10 17 12 12 12 18 10 40 40 40 40 40 40 40 31 26 26 30 41 31 26 30 17 12 12 12 12 12 12 12 
12 12 12 13 12 12 18 40 39 42 42 42 39 40 40 40 40 40 40 40 10 17 12 12 12 18 11 40 40 40 40 40 40 40 31 26 26 32 33 34 26 30 17 12 13 12 12 12 12 12 
12 12 12 12 13 12 18 40 39 42 42 42 39 40 40 40 40 40 40 40 10 19 20 20 20 21 10 40 40 40 40 40 40 40 31 26 26 26 26 26 26 30 17 12 12 12 12 12 12 12 
12 12 12 12 12 12 18 40 39 39 42 39 39 40 40 40 40 40 40 40 11 10 35 33 36 10 10 40 40 40 40 40 40 40 37 28 28 29 26 27 28 38 17 13 12 12 12 12 12 12 
12 12 12 12 12 12 18 40 40 40 10 40 40 40 40 40 40 40 40 40 40 40 31 26 30 40 40 40 40 40 40 40 40 40 40 40 40 31 26 30 14 15 25 12 12 12 12 12 12 12 
12 12 12 12 13 12 18 40 40 40 10 40 40 40 40 40 40 40 40 40 40 40 31 26 30 40 40 40 40 40 40 40 40 40 40 40 40 31 26 30 17 12 12 12 12 13 12 12 12 12 
12 12 12 12 12 12 24 15 16 40 10 40 40 40 40 40 40 40 40 40 40 40 31 26 30 40 40 40 40 40 40 40 40 40 40 40 40 31 26 30 17 12 12 12 12 12 12 12 12 12 
12 12 12 12 12 12 12 12 18 40 10 40 40 40 40 40 40 40 40 40 40 40 31 26 30 10 10 40 40 40 40 40 40 40 40 40 40 31 26 30 17 12 12 12 12 12 13 12 12 12 
12 12 13 12 12 12 12 22 21 40 10 40 40 40 40 40 40 40 40 40 40 40 31 26 30 40 40 40 40 40 40 40 40 40 40 35 33 34 26 30 17 12 12 13 12 12 12 12 12 12 
12 12 12 12 12 12 12 18 10 10 10 40 40 40 40 40 40 40 40 40 40 40 31 26 30 40 40 40 40 40 40 40 40 40 40 31 26 26 26 30 17 12 12 12 12 12 12 12 12 12 
12 12 12 13 12 12 12 18 10 40 40 40 40 40 40 40 40 40 40 40 40 10 31 26 30 10 40 40 40 40 40 40 40 40 40 31 26 27 28 38 17 12 13 12 12 12 12 12 12 12 
12 12 12 12 12 12 12 18 10 40 40 40 10 35 33 33 33 33 33 33 33 33 34 26 32 33 33 33 33 33 33 33 33 33 33 34 26 30 10 40 17 12 12 12 12 12 12 12 12 12 
12 12 12 12 12 13 12 18 10 40 40 40 11 31 26 26 26 26 26 26 26 26 26 26 26 26 26 26 26 26 26 26 26 26 26 26 26 30 10 14 25 12 12 12 12 12 12 12 12 12 
12 12 12 12 12 12 13 18 10 10 40 40 10 37 28 28 28 28 28 28 28 28 29 26 27 28 28 28 28 28 28 28 28 28 28 29 26 30 10 17 12 13 12 12 12 12 12 12 12 12 
12 12 12 12 12 12 12 24 16 10 40 40 10 40 40 40 40 40 40 40 40 10 31 26 30 10 40 40 40 40 40 40 40 40 40 31 26 30 10 17 12 12 12 12 13 12 12 12 12 12 
12 12 12 12 12 12 12 12 18 10 40 40 10 40 40 40 40 40 40 40 40 40 31 26 30 40 40 40 40 40 40 40 40 40 40 31 26 30 11 17 12 12 12 12 12 12 12 12 12 12 
12 12 12 12 12 13 12 22 21 10 40 40 10 10 10 40 40 40 40 40 40 40 31 26 30 40 40 40 40 40 40 40 40 40 40 31 26 30 10 17 12 12 12 13 12 12 12 12 12 12 
12 12 12 12 12 12 12 18 10 10 40 40 40 40 10 40 40 40 40 40 40 40 31 26 30 40 40 40 40 40 40 40 40 40 40 31 26 30 10 17 12 12 12 12 12 12 12 12 12 12 
12 12 12 13 12 12 12 18 10 40 40 40 40 40 10 40 40 40 40 40 40 40 31 26 30 40 40 10 40 40 40 40 40 40 40 31 26 30 10 17 12 13 12 12 12 12 12 12 12 12 
12 12 12 12 12 12 12 18 10 40 40 40 40 40 10 40 40 40 40 40 40 40 31 26 30 40 40 40 40 40 10 40 40 40 40 31 26 30 10 17 12 12 12 12 12 12 12 12 12 12 
12 12 12 12 12 12 13 18 10 10 10 10 10 10 10 40 40 40 40 40 40 40 31 26 30 40 40 40 40 40 10 40 40 40 40 37 28 38 10 17 12 12 12 12 13 12 12 12 12 12 
12 12 12 12 12 12 12 18 10 10 11 10 10 10 10 40 40 40 40 40 40 40 31 26 30 40 40 40 40 40 40 40 40 40 40 40 10 40 14 25 12 12 13 12 12 12 12 12 12 12 
12 12 12 12 12 12 12 24 16 10 10 10 10 10 10 40 40 40 40 40 40 40 31 26 30 40 40 40 40 40 40 40 40 40 40 10 10 10 17 12 12 12 12 12 12 12 12 12 12 12 
12 12 12 12 12 13 12 12 18 10 10 10 10 11 10 40 40 40 40 40 40 40 31 26 30 40 40 40 40 40 40 40 40 40 40 10 10 10 17 12 12 12 12 12 12 12 13 12 12 12 
12 12 12 12 12 12 12 12 18 11 10 10 10 10 10 40 40 40 40 40 40 40 31 26 30 40 40 40 40 40 40 40 40 40 40 10 10 11 17 12 12 13 12 12 12 12 12 12 12 12 
12 12 12 12 12 12 12 12 18 10 10 10 10 10 10 40 40 40 40 40 40 40 31 26 30 40 40 40 40 40 40 40 40 40 40 10 10 10 17 12 12 12 12 12 12 12 12 12 12 12 
12 12 12 12 13 12 12 22 21 40 40 40 40 40 40 40 40 40 40 40 40 40 37 28 38 40 40 40 40 40 40 40 40 40 40 11 10 10 19 23 12 12 12 12 12 12 12 12 12 12 
12 12 12 12 12 12 12 18 40 40 40 40 40 40 40 40 40 40 40 10 10 10 10 10 10 10 10 40 40 40 40 40 40 40 10 10 10 10 10 19 23 12 12 12 13 12 12 12 12 12 
12 12 12 12 12 12 13 18 40 40 40 40 40 40 40 40 40 40 10 10 10 10 10 10 40 10 10 10 40 40 10 40 40 10 10 10 10 10 10 10 17 12 12 12 12 12 12 12 12 12 
12 12 12 12 12 12 12 18 10 40 40 40 40 40 40 40 40 40 10 11 10 10 10 10 10 40 10 10 40 40 40 40 10 10 10 10 10 11 10 10 17 12 13 12 12 12 12 12 12 12 
12 12 12 12 12 12 12 18 10 40 40 40 40 40 40 40 40 40 10 10 11 40 10 10 10 10 10 10 10 40 40 40 10 10 10 10 10 40 10 10 17 12 12 12 12 12 12 12 12 12 
12 12 13 12 12 12 12 18 10 40 40 40 40 40 40 40 40 40 10 10 10 40 10 10 10 10 10 10 10 10 10 10 10 10 40 10 10 10 10 10 17 12 12 12 12 13 12 12 12 12 
12 12 12 12 12 12 12 18 40 40 40 40 40 40 40 14 15 15 16 10 10 10 10 10 11 10 10 14 15 15 16 10 10 10 10 10 10 10 11 10 17 12 12 12 12 12 12 13 12 12 
12 12 12 12 12 12 12 18 40 40 40 40 40 40 14 25 12 12 24 16 10 10 10 10 10 10 14 25 12 12 18 10 10 40 10 10 40 10 10 10 17 12 12 12 12 12 12 12 12 12 
12 12 12 12 13 12 12 24 15 15 15 15 15 15 25 12 12 12 12 24 15 15 15 15 15 15 25 12 13 12 24 16 10 40 10 10 10 10 14 15 25 12 13 12 12 12 12 12 12 12 
12 12 12 12 12 12 12 12 12 12 12 12 12 12 12 12 12 12 13 12 12 12 12 12 12 12 12 12 12 12 12 24 15 15 15 15 15 15 25 12 12 12 12 12 12 12 13 12 12 12 
12 12 12 12 12 12 12 12 12 12 12 13 12 12 12 12 13 12 12 12 12 12 12 12 12 12 12 12 12 12 12 12 12 12 12 12 13 12 12 12 12 12 12 13 12 12 12 12 12 12 
12 12 12 12 12 12 13 12 12 12 12 12 12 12 12 12 12 12 12 12 12 12 12 12 13 12 12 12 12 13 12 12 12 12 12 12 12 12 12 12 12 12 12 12 12 12 12 12 12 12 
12 12 12 12 12 12 12 12 12 12 12 12 12 12 13 12 12 12 12 12 13 12 12 12 12 12 12 12 12 12 12 12 13 12 12 12 12 12 12 13 12 12 12 12 12 12 12 12 12 12 
12 12 12 12 12 12 12 12 12 12 12 12 12 12 12 12 12 12 12 12 12 12 12 12 12 12 12 13 12 12 12 12 12 12 12 12 12 12 12 12 12 12 12 12 12 13 12 12 12 12 
12 12 12 12 12 12 12 12 12 12 12 12 12 12 12 12 12 12 12 12 12 12 12 12 12 12 12 12 12 12 12 12 12 12 12 12 12 12 12 12 12 12 12 12 12 12 12 12 12 12 
